0000000100
1100111110
0101100000
0101000000
0000100011
0101000111
0000000011
0101000000
0000000000