111111111111111
100000000000011
101111111111011
101111000000011
101111011111111
100000000000001
101111011111101
100000011111101
111111111111111