000000000000111
010000000111111
010001111000000
011111000000000
010000000000000
000000111111110
000000111000000
111111111111100
000000000000000
000000000000000
000000000000000
000000000000000
000000000000000
000000000000000
111111111111100