000000001000000
011111011000000
010001011111000
010001111100000
010000000000000
000011100000000
000001000000000
000001000000000
000001000000000
000000000000000
111111110000000
111000000001110
111111111111100
111111100000000
111111111111110

